222222222222222
271313131313112
212121212121212
231313131313132
212121212121212
231313131313132
212121212121212
231313131313132
212121212121212
231313131313132
212121212121212
231313131313132
212121212121212
211313131313172
222222222222222
