222222222222222
271333333333112
212121212121212
233333333333332
212121212121212
233333333333332
212121212121212
233333333333332
212121212121212
233333333333332
212121212121212
233333333333332
212121212121212
211333333333172
222222222222222
