222222222222222
271333333333112
212121212121212
231333333333132
232321212123232
231313333313132
232323212323232
231313131313132
232323212323232
231313333313132
232321212123232
231333333333132
212121212121212
211333333333172
222222222222222
