2222222222222222
2711122111111112
2121122333333332
2131122111111112
2131133333332272
2222222222222222
