2222222222222222222222222
2713113131313131313131172
2121212121212121212121212
2311331313131313131313132
2121212121212121212121212
2311331313131313131313132
2121212121212121212121212
2311331313131313131313132
2121212121212121212121212
2711331313131313131313172
2222222222222222222222222