222222222222222
271311111113112
212323232323212
233111111111332
212123232321212
213131111131312
212121232121212
213131313131312
212121232121212
213131111131312
212123232321212
233111111111332
212323232323212
211311111113172
222222222222222
