222222222222222
271313131313112
212323232323212
231313131313132
232323232323232
231313131313132
232323232323232
231313131313132
232323232323232
231313131313132
232323232323232
231313131313132
212323232323212
211313131313172
222222222222222
