222222222222222
271331313133112
212323232323212
233131313131332
232323232323232
213131313131312
232323232323232
213131313131312
232323232323232
213131313131312
232323232323232
233131313131332
212323232323212
211331313133172
222222222222222
