222222222222222
271313111313112
212321232123212
233331333133332
212321232123212
231113111311132
212321232123212
213331333133312
212321232123212
231113111311132
212321232123212
233331333133332
212321232123212
211313111313172
222222222222222
