222222222222222
271331111133112
212321232123212
233111313111332
232123212321232
211131111131112
212321232123212
213111313111312
212321232123212
211131111131112
232123212321232
233111313111332
212321232123212
211331111133172
222222222222222
