222222222222222222222222222222
272131322222222222222311111172
212131212121221211112333222222
212131211212121212121321113112
212112323111221111212121213312
212131311211321121212121212212
213333333123121212121211211212
213131112111111111111121211212
211212112121111111211212111212
211311121212121212112121211212
222222223123122112121212211212
271311121212121121212122111272
222222222222222222222222222222